==========
==========
##########
#    X X #
# @ C  # #
#E   C C #
######   #
=====#####
==========
==========
